NO ./textures/north.xpm
SO ./textures/south.xpm
WE ./textures/west.xpm
EA 	./textures/east.xpm
F 56,0,0
C 25,30,0


111111111
1001 110011
1001   1001
1001  111111
1111111111111111                         11111
111111111111                               1001
101   1N00111                               11111
111111111111
1000011111
111111
