NO ./textures/north.xpm
SO ./textures/south.xpm
WE ./textures/west.xpm
EA     ./textures/east.xpm
F 56,0,0
C 25,30,0

111111
100001
100001
100001
100001
100001
111111
