NO ./textures/north.png
SO ./textures/south.png
WE ./textures/west.png
EA     ./textures/east.png

F 56,0,0
C 25,30,0

11111111
100000N1
10000001
10100001
10010001
10000001
10000011
11111111

