NO ./textures/north.png
SO ./textures/south.png
WE ./textures/west.png
EA     ./textures/east.png

F 255,0,0
C 0,255,0

1111111111111111
1000000000000001
1000000100000001
1010000111111111
10000001
10000001
1010N001
10010001
10000001
10000011
11100111
10010001
10000001
10000011
11111111

