NO ./textures/north.png
SO ./textures/south.png
WE ./textures/east.png
EA ./textures/west.png

F 0,0,0
C 255,255,255

1111111111111111
1000000011100001
1011000000000001
1001000000100001
1000000N00000001
10E0000001100001
1001000000000001
1000000011100001
1111111111111111

